...............
......#........
......#####....
..........#E...
..........#....
..........#....
...S......#....
..........###..
...............
...............