S.#.#.#...#
#.#.#.#.###
#.....#...#
#####.###.#
#...#.....#
#.#.###.###
#.#.......#
#.#####.#.#
#.....#.#.E
