S...#.....#
#.###.#.###
#...#.#...#
#.###.###.#
#.#.......#
#...#.#.###
#.#...#...#
#.#####.#.#
#.......#.E